		
HEAVEN_0   
		   DC.B 3,3,3,3,3,3,3,3,3,3,3,3,3,3,3,3,3,3,3,3,0
		   DC.B	1,1,1,1,1,1,1,1,1,1,1,1,1,1,1,1,1,1,1,1,0
		   DC.B	1,1,1,1,1,1,1,1,1,1,1,1,1,1,1,1,1,1,1,1,0
		   DC.B 5,5,5,5,5,5,5,5,5,5,5,5,5,5,5,5,5,5,5,5,0
		   DC.B 5,5,5,5,5,5,5,5,5,5,5,5,5,5,5,5,5,5,5,5,0
		   DC.B 5,5,5,5,5,5,5,5,5,5,5,5,5,5,5,5,5,5,5,5,0
		   DC.B 7,7,1,1,1,1,7,7,1,1,1,1,7,7,1,1,1,1,7,7,0
		   DC.B 7,7,1,7,7,1,7,7,1,7,7,1,7,7,1,7,7,1,7,7,0
		   DC.B 7,7,1,1,1,1,7,7,1,1,1,1,7,7,1,1,1,1,7,7,0
		   DC.B 5,5,5,5,5,5,5,5,5,5,5,5,5,5,5,5,5,5,5,5,0
		   DC.B 5,5,5,5,5,5,5,5,5,5,5,5,5,5,5,5,5,5,5,5,0
		   DC.B 5,5,5,5,5,5,5,5,5,5,5,5,5,5,5,5,5,5,5,5,0
		   DC.B	1,1,1,1,1,1,1,1,1,1,1,1,1,1,1,1,1,1,1,1,0
		   DC.B	1,1,1,1,1,1,1,1,1,1,1,1,1,1,1,1,1,1,1,1,0
       DC.B 3,3,3,3,3,3,3,3,3,3,3,3,3,3,3,3,3,3,3,3,11
        
HELL_0
		DC.B 2,2,2,2,2,2,2,2,2,2,2,2,2,2,2,2,2,2,2,2,0
		DC.B 2,6,6,6,6,6,2,6,6,6,6,6,6,2,6,6,6,6,6,2,0
		DC.B 2,6,6,4,6,6,2,6,6,6,6,6,6,2,6,6,4,6,6,2,0
		DC.B 2,6,6,4,6,6,6,6,6,6,6,6,6,6,6,6,4,6,6,2,0
		DC.B 2,6,4,4,4,6,6,6,6,6,6,6,6,6,6,4,4,4,6,2,0
		DC.B 2,6,6,4,6,6,2,6,6,6,6,6,6,2,6,6,4,6,6,2,0
		DC.B 2,6,6,6,6,6,2,6,6,6,6,6,6,2,6,6,6,6,6,2,0
		DC.B 2,2,2,2,2,2,2,2,2,6,6,2,2,2,2,2,2,2,2,2,0
		DC.B 2,2,2,2,2,2,2,2,2,6,6,2,2,2,2,2,2,2,2,2,0
		DC.B 2,6,6,6,6,6,6,6,6,6,6,6,6,6,6,6,6,6,6,2,0
		DC.B 2,6,2,2,2,2,2,2,2,2,2,2,2,2,2,2,2,2,6,2,0
		DC.B 2,6,2,4,4,4,4,4,4,4,4,4,4,4,4,4,4,2,6,2,0
		DC.B 2,6,2,2,2,2,2,2,2,2,2,2,2,2,2,2,2,2,6,2,0
		DC.B 2,6,6,6,6,6,6,6,6,6,6,6,6,2,6,6,6,6,6,2,0
		DC.B 2,2,2,2,2,2,2,2,2,8,8,2,2,2,2,2,2,2,2,2,11
		
HELL_1
	
		DC.B 2,2,2,2,2,2,2,2,2,8,8,2,2,2,2,2,2,2,2,2,0
		DC.B 2,6,6,6,6,6,6,6,6,6,6,6,6,6,6,6,6,6,6,2,0
		DC.B 2,6,6,6,6,6,6,6,6,6,6,6,6,6,6,6,6,6,6,2,0
		DC.B 2,6,6,6,6,6,6,6,6,6,6,6,6,6,6,6,6,6,6,2,0
		DC.B 2,6,6,6,6,6,6,6,6,4,4,6,6,6,6,6,6,6,6,2,0
		DC.B 2,6,6,6,6,6,6,6,4,4,4,4,6,6,6,6,6,6,6,2,0
		DC.B 2,6,6,6,6,6,6,4,4,4,4,4,4,6,6,6,6,6,6,2,0
		DC.B 2,6,6,6,6,6,6,6,4,4,4,4,6,6,6,6,6,6,6,2,0
		DC.B 2,6,6,6,6,6,6,6,6,4,4,6,6,6,6,6,6,6,6,2,0
		DC.B 2,6,6,6,6,6,6,6,6,6,6,6,6,6,6,6,6,6,6,2,0
		DC.B 2,2,8,2,2,2,2,2,6,6,6,6,2,2,2,2,2,8,2,2,0
		DC.B 2,6,6,6,2,2,2,2,6,6,6,6,2,2,2,2,6,6,6,2,0
		DC.B 2,6,6,6,2,2,2,2,6,6,6,6,2,2,2,2,6,6,6,2,0
		DC.B 2,6,6,6,2,2,2,2,6,6,6,6,2,2,2,2,6,6,6,2,0
		DC.B 2,2,2,2,2,2,2,2,2,8,8,2,2,2,2,2,2,2,2,2,11
		
HELL_END

		DC.B 2,2,2,2,2,2,2,2,2,8,8,2,2,2,2,2,2,2,2,2,0
		DC.B 2,6,6,6,6,6,6,6,6,6,6,6,6,6,6,6,6,6,6,2,0
		DC.B 2,6,6,6,6,6,6,6,6,6,6,6,6,6,6,6,6,6,6,2,0
		DC.B 2,6,6,6,6,6,6,6,6,4,4,6,6,6,6,6,6,6,6,2,0
		DC.B 2,6,6,6,6,6,6,6,6,4,4,6,6,6,6,6,6,6,6,2,0
		DC.B 2,6,6,6,6,6,6,6,6,4,4,6,6,6,6,6,6,6,6,2,0
		DC.B 2,6,6,6,6,6,6,6,6,4,4,6,6,6,6,6,6,6,6,2,0
		DC.B 2,6,6,6,6,6,6,6,6,4,4,6,6,6,6,6,6,6,6,2,0
		DC.B 2,6,6,6,6,6,6,4,4,4,4,4,4,6,6,6,6,6,6,2,0
		DC.B 2,6,6,6,6,6,6,4,4,4,4,4,4,6,6,6,6,6,6,2,0
		DC.B 2,6,6,6,6,6,6,6,6,4,4,6,6,6,6,6,6,6,6,2,0
		DC.B 2,6,6,6,6,6,6,6,6,4,4,6,6,6,6,6,6,6,6,2,0
		DC.B 2,6,6,6,6,6,6,6,6,6,6,6,6,6,6,6,6,6,6,2,0
		DC.B 2,6,6,6,6,6,6,6,6,6,6,6,6,6,6,6,6,6,6,2,0
		DC.B 2,2,2,2,2,2,2,2,2,2,2,2,2,2,2,2,2,2,2,2,11
